WWWWWWEEEWWWWWWW
Ws  sWWWWWAAAAAW
W    WWWWWc P  W
W    WWWWWC    W
W    S   S    QW
W             qW
WWWWWWWWWWWWWWWW
