WWWWWWEEEWWWWWWW
Ws  sWWWWWAAAAAW
W    WWWWW  P  W
W    WWWWW     W
W    S   S     W
W              W
WWWWWWWWWWWWWWWW
