WWWWWWWWWW
W        W
W  Q Q   W
W  AA S  W
WSS    Q W
W     A  W
Wsss PAQ W
Wqqs  S  W
Wqqs  S  W
WWWWWWWWWW